    ######          
    ##   #          
    ##$  #          
  ####  $##         
  ##  $ $ #         
#### # ## #   ######
##   # ## #####  ..#
## $  $          ..#
###### ### #@##  ..#
    ##     #########
    ########        
