#######
#     #
#.$ $.#
##$@ ##
#.    #
#     #
#######
