#######
#.$   #
#     #
### ###
#     #
#  @  #
#######
