#####
#@ .#
#.  #
# $.#
# $##
# $ #
#   #
#####