####### 
#    .##
#.$  $@#
#####$ #
   #   #
   # $ #
   #. .#
   #####